
┌───┬───┬───┬───┬───┐
│ o │ o │ o │ E │ # │
├───┼───┼───┼───┼───┤
│ E │ # │ o │ # │ # │
├───┼───┼───┼───┼───┤
│ o │ # │ o │ o │ o │
├───┼───┼───┼───┼───┤
│ o │ # │ S │ o │ # │
└───┴───┴───┴───┴───┘
